11111
11E11
1RRL1
1RLL1
1RRL1
1RLL1
1RRL1
1RLL1
1RRL1
1RLL1
1RRL1
1RLL1
1RRL1
1RLL1
1RRL1
1RLL1
1RRL1
11C11
11P11
11111