1111111
1000001
1000001
1000001
1000001
1R00001
1110111
1P000E1
1111111