1111111
1000001
1000001
1000001
1000001
1R00001
1110111
1P00C01
1111111