1111111
1000001
1000001
1000001
1000001
1R00001
1110111
1000CE1
1111111