1111111111111
111111E111111
111111C111111
10R00L00R00L1
1011111111101
1L11111111101
100R00R00L001
111111C111111
1R0000R000CC1
11111111111C1
11R000L000L01
111C111111111
111R0000L0111
111111C111111
11110000L1111
1111110111111
111111P111111
1111111111111