1111111111111
1L1RL1E1LR1L1
1R1LR101RL1R1
1L111101111R1
1R1LRLCRLR1L1
1L111101111R1
1R1LRLCRLR1L1
1011110111101
1CR0R000000P1
1111111111111