11111
11E11
11011
1RLR1
10L11
11001
1R0C1
100L1
10001
1CLR1
10001
1R001
100C1
100L1
1C001
1R001
10C01
11011
11P11
11111