11111
11E11
11011
1RRR1
10L11
11001
1R0C1
1LLL1
1RRR1
1CRL1
10001
1R001
1LRC1
100L1
1C001
1R001
10001
11011
11P11
11111