111111111111111
111111LCR111111
11111R000L11111
1111R00000L1111
1P0C000C0000CE1
1111R00000L1111
11111R000L11111
111111LCR111111
111111111111111