111111111111111
1E111C11C1R0001
1000000L010CC01
11110111010CC01
11R000L100000L1
111101111011111
1C0000RC101P0C1
101010101011011
1CL0000C0000001
111111111111111