111111111
1R001R001
110111011
1R001R001
110111011
1R001R001
110111011
1P0000CE1
111111111