1111111
1CCCCC1
1CCCCC1
1CCCCC1
1CCCCC1
1CCCCC1
1110111
1P00CE1
1111111