1111111111111
1R0001L000001
1L100R0010001
1R000L0000001
1R000L0001001
1R000L0100001
11010R0000001
1111111111111
1E0000C0000P1
1111111111111