1111111
111E111
1110111
1R00001
100C001
10000L1
1110111
111P111
1111111