111111111111111
11P111111111E11
110111111111011
110111111111C11
100L1111111R001
110111111111011
110111111111011
110001111100011
111101111101111
111101111101111
1R00001110000L1
111011111110111
111011111110111
110011111110011
110111111111011
110111111111011
1000L11111R0001
110111111111011
110111111111011
110000000000011
111111111111111