11111111111
10000000001
1L111111101
10100000001
10101111101
1R101111101
10101111101
1L1C00010C1
10100100011
1R100000001
10000000001
1L000000101
10010000001
1R0000100C1
11100000111
10C00000C01
1E1000001P1
11111111111