1111111
1P01001
1101011
1R00001
111C111
1R00001
1110111
1C000C1
1101011
1R010E1
1111111